43 41 16
20 20
Data/TileSet/castleTileSet-Purple.txt

0 0 0 3 3 3 3 3 3 3 0 0 0 0 0 0 0 0 0 0 0 0 0 0 0 0 0 0 0 0 0 3 3 3 3 3 3 3 0 0 0 
0 3 3 3 2 2 2 2 2 3 3 3 0 0 0 0 0 0 0 0 0 0 0 0 0 0 0 0 0 3 3 3 2 2 2 2 2 3 3 3 0 
0 3 2 2 2 2 2 2 2 2 2 3 0 0 0 0 0 0 0 0 0 0 0 0 0 0 0 0 0 3 2 2 2 2 2 2 2 2 2 3 0 
3 3 2 2 1 1 1 1 1 2 2 3 3 3 3 3 3 3 3 3 3 3 3 3 3 3 3 3 3 3 2 2 1 1 1 1 1 2 2 3 3 
3 2 1 1 1 1 1 1 1 1 1 2 2 2 2 2 2 2 2 2 2 2 2 2 2 2 2 2 2 2 1 1 1 1 1 1 1 1 1 2 3 
3 2 1 1 1 1 1 1 1 1 1 2 2 2 2 2 2 2 2 2 2 2 2 2 2 2 2 2 2 2 1 1 1 1 1 1 1 1 1 2 3 
3 1 1 1 1 1 1 1 1 1 1 1 1 1 1 1 1 1 1 1 1 1 1 1 1 1 1 1 1 1 1 1 1 1 1 1 1 1 1 2 3 
3 1 1 1 1 1 1 1 1 1 1 1 1 1 1 1 1 1 1 1 1 1 1 1 1 1 1 1 1 1 1 1 1 1 1 1 1 1 1 2 3 
3 1 1 1 1 1 1 1 1 1 1 1 1 1 1 1 1 1 1 1 1 1 1 1 1 1 1 1 1 1 1 1 1 1 1 1 1 1 1 2 3 
3 3 1 1 1 1 1 1 1 1 1 3 3 3 3 3 3 3 3 3 3 3 3 3 3 3 3 3 3 3 1 1 1 1 1 1 1 1 1 3 3 
2 3 1 1 1 1 1 1 1 1 1 3 2 2 2 2 2 2 2 2 2 2 2 2 2 2 2 2 2 3 1 1 1 1 1 1 1 1 1 3 2 
2 3 3 3 1 1 1 1 1 3 3 3 2 2 2 2 2 2 2 2 2 2 2 2 2 2 2 2 2 3 3 3 1 1 1 1 1 3 3 3 2 
0 2 2 3 1 1 1 1 1 3 2 2 0 0 0 0 0 0 0 0 0 0 0 0 0 0 0 0 0 2 2 3 1 1 1 1 1 3 2 2 0 
0 2 2 3 1 1 1 1 1 3 2 2 0 0 0 3 3 3 3 3 3 3 3 3 3 3 0 0 0 2 2 3 1 1 1 1 1 3 2 2 0 
0 0 0 3 1 1 1 1 1 3 0 0 0 0 3 2 2 2 2 2 2 2 2 2 2 2 3 0 0 0 0 3 1 1 1 1 1 3 0 0 0 
0 0 0 3 1 1 1 1 1 3 0 0 0 3 2 2 2 2 2 2 2 2 2 2 2 2 2 3 0 0 0 3 1 1 1 1 1 3 0 0 0 
0 0 0 3 1 1 1 1 1 3 0 0 3 2 2 1 1 1 1 1 1 1 1 1 1 1 2 2 3 0 0 3 1 1 1 1 1 3 0 0 0 
0 0 0 3 1 1 1 1 1 3 0 0 3 2 1 1 1 1 1 1 1 1 1 1 1 1 1 2 3 0 0 3 1 1 1 1 1 3 0 0 0 
0 0 0 3 1 1 1 1 1 3 0 0 3 1 1 1 1 1 1 1 1 1 1 1 1 1 1 1 3 0 0 3 1 1 1 1 1 3 0 0 0 
0 0 0 3 1 1 1 1 1 3 0 0 3 1 1 1 1 1 1 1 1 1 1 1 1 1 1 1 3 0 0 3 1 1 1 1 1 3 0 0 0 
0 0 0 3 1 1 1 1 1 3 0 0 3 1 1 1 1 1 1 1 1 1 1 1 1 1 1 1 3 0 0 3 1 1 1 1 1 3 0 0 0 
0 0 0 3 1 1 1 1 1 3 0 0 3 1 1 1 1 1 1 1 1 1 1 1 1 1 1 1 3 0 0 3 1 1 1 1 1 3 0 0 0 
0 0 0 3 1 1 1 1 1 3 0 0 3 1 1 1 1 1 1 1 1 1 1 1 1 1 1 1 3 0 0 3 1 1 1 1 1 3 0 0 0 
0 0 0 3 1 1 1 1 1 3 0 0 3 1 1 1 1 1 1 1 1 1 1 1 1 1 1 1 3 0 0 3 1 1 1 1 1 3 0 0 0 
0 0 0 3 1 1 1 1 1 3 0 0 3 1 1 1 1 1 1 1 1 1 1 1 1 1 1 1 3 0 0 3 1 1 1 1 1 3 0 0 0 
0 0 0 3 1 1 1 1 1 3 0 0 3 1 1 1 1 1 1 1 1 1 1 1 1 1 1 1 3 0 0 3 1 1 1 1 1 3 0 0 0 
0 0 0 3 1 1 1 1 1 3 0 0 3 1 1 1 1 1 1 1 1 1 1 1 1 1 1 1 3 0 0 3 1 1 1 1 1 3 0 0 0 
0 0 0 3 1 1 1 1 1 3 0 0 3 1 1 1 1 1 1 1 1 1 1 1 1 1 1 1 3 0 0 3 1 1 1 1 1 3 0 0 0 
0 0 0 3 1 1 1 1 1 3 0 0 2 3 1 1 1 1 1 1 1 1 1 1 1 1 1 3 2 0 0 3 1 1 1 1 1 3 0 0 0 
0 3 3 3 1 1 1 1 1 3 3 3 2 2 3 3 1 1 1 1 1 1 1 1 1 3 3 2 2 3 3 3 1 1 1 1 1 3 3 3 0 
0 3 2 2 1 1 1 1 1 2 2 3 0 2 2 3 1 1 1 1 1 1 1 1 1 3 2 2 0 3 2 2 1 1 1 1 1 2 2 3 0 
3 3 2 2 1 1 1 1 1 2 2 3 3 3 3 3 1 1 1 1 1 1 1 1 1 3 3 3 3 3 2 2 1 1 1 1 1 2 2 3 3 
3 2 1 1 1 1 1 1 1 1 1 2 2 2 2 2 1 1 1 1 1 1 1 1 1 2 2 2 2 2 1 1 1 1 1 1 1 1 1 2 3 
3 2 1 1 1 1 1 1 1 1 1 2 2 2 2 2 1 1 1 1 1 1 1 1 1 2 2 2 2 2 1 1 1 1 1 1 1 1 1 2 3 
3 1 1 1 1 1 1 1 1 1 1 1 1 1 1 1 1 1 1 1 1 1 1 1 1 1 1 1 1 1 1 1 1 1 1 1 1 1 1 1 3 
3 1 1 1 1 1 1 1 1 1 1 1 1 1 1 1 1 1 1 1 1 1 1 1 1 1 1 1 1 1 1 1 1 1 1 1 1 1 1 1 3 
3 1 1 1 1 1 1 1 1 1 1 1 1 1 1 1 1 1 1 1 1 1 1 1 1 1 1 1 1 1 1 1 1 1 1 1 1 1 1 1 3 
3 3 1 1 1 1 1 1 1 1 1 3 3 3 3 3 3 3 3 3 3 3 3 3 3 3 3 3 3 3 1 1 1 1 1 1 1 1 1 3 3 
2 3 1 1 1 1 1 1 1 1 1 3 2 2 2 2 2 2 2 2 2 2 2 2 2 2 2 2 2 3 1 1 1 1 1 1 1 1 1 3 2 
2 3 3 3 1 1 1 1 1 3 3 3 2 2 2 2 2 2 2 2 2 2 2 2 2 2 2 2 2 3 3 3 1 1 1 1 1 3 3 3 2 
0 2 2 3 3 3 3 3 3 3 2 2 0 0 0 0 0 0 0 0 0 0 0 0 0 0 0 0 0 2 2 3 3 3 3 3 3 3 2 2 0 
0 2 2 2 2 2 2 2 2 2 2 2 0 0 0 0 0 0 0 0 0 0 0 0 0 0 0 0 0 2 2 2 2 2 2 2 2 2 2 2 0 
0 0 0 2 2 2 2 2 2 2 0 0 0 0 0 0 0 0 0 0 0 0 0 0 0 0 0 0 0 0 0 2 2 2 2 2 2 2 0 0 0 

0 1 1 1
1
Claudius
Scripts/level5end.txt

1
20 20 T
Scripts/level5.txt